{
  "_metadata": {
	"description": "Large classic grid layout data. 0: Empty, 1: Wall, 2: Pellet, 3: Power Pellet, 4: Player Spawn, 5: Ghost Spawn, 6: Portal Left, 7: Portal Right",
	"author": "Enrique González Gutiérrez",
	"email": "enrique.gonzalez.gutierrez@gmail.com"
  },
  "grid_width": 21,
  "grid_height": 21,
  "layout": [
	[1, 1, 1, 1, 1, 1, 1, 1, 1, 1, 1, 1, 1, 1, 1, 1, 1, 1, 1, 1, 1],
	[1, 3, 2, 2, 2, 2, 2, 2, 2, 2, 1, 2, 2, 2, 2, 2, 2, 2, 2, 3, 1],
	[1, 2, 1, 1, 1, 2, 1, 1, 1, 2, 1, 2, 1, 1, 1, 2, 1, 1, 1, 2, 1],
	[1, 2, 1, 1, 1, 2, 1, 1, 1, 2, 1, 2, 1, 1, 1, 2, 1, 1, 1, 2, 1],
	[1, 2, 2, 2, 2, 2, 2, 2, 2, 2, 2, 2, 2, 2, 2, 2, 2, 2, 2, 2, 1],
	[1, 2, 1, 1, 1, 2, 1, 2, 1, 1, 1, 1, 1, 2, 1, 2, 1, 1, 1, 2, 1],
	[1, 2, 2, 2, 2, 2, 1, 2, 2, 2, 1, 2, 2, 2, 1, 2, 2, 2, 2, 2, 1],
	[1, 1, 1, 1, 1, 2, 1, 1, 1, 0, 1, 0, 1, 1, 1, 2, 1, 1, 1, 1, 1],
	[0, 0, 0, 0, 1, 2, 1, 0, 0, 0, 0, 0, 0, 0, 1, 2, 1, 0, 0, 0, 0],
	[1, 1, 1, 1, 1, 2, 1, 0, 1, 1, 5, 1, 1, 0, 1, 2, 1, 1, 1, 1, 1],
	[6, 0, 0, 0, 0, 2, 0, 0, 1, 5, 0, 5, 1, 0, 0, 2, 0, 0, 0, 0, 7],
	[1, 1, 1, 1, 1, 2, 1, 0, 1, 1, 5, 1, 1, 0, 1, 2, 1, 1, 1, 1, 1],
	[0, 0, 0, 0, 1, 2, 1, 0, 0, 0, 0, 0, 0, 0, 1, 2, 1, 0, 0, 0, 0],
	[1, 1, 1, 1, 1, 2, 1, 0, 1, 1, 1, 1, 1, 0, 1, 2, 1, 1, 1, 1, 1],
	[1, 2, 2, 2, 2, 2, 2, 2, 2, 2, 1, 2, 2, 2, 2, 2, 2, 2, 2, 2, 1],
	[1, 2, 1, 1, 1, 2, 1, 1, 1, 2, 1, 2, 1, 1, 1, 2, 1, 1, 1, 2, 1],
	[1, 3, 2, 2, 1, 2, 2, 2, 2, 2, 4, 2, 2, 2, 2, 2, 1, 2, 2, 3, 1],
	[1, 1, 1, 2, 1, 2, 1, 2, 1, 1, 1, 1, 1, 2, 1, 2, 1, 2, 1, 1, 1],
	[1, 2, 2, 2, 2, 2, 1, 2, 2, 2, 1, 2, 2, 2, 1, 2, 2, 2, 2, 2, 1],
	[1, 2, 1, 1, 1, 1, 1, 1, 1, 2, 1, 2, 1, 1, 1, 1, 1, 1, 1, 2, 1],
	[1, 1, 1, 1, 1, 1, 1, 1, 1, 1, 1, 1, 1, 1, 1, 1, 1, 1, 1, 1, 1]
  ]
}
